14 7
0 2
9 3
0	0	1	1	1	1	1
0	0	1	0	1	0	0
0	0	1	0	1	0	0
0	0	0	0	1	0	0
1	1	1	1	1	1	0
1	0	0	0	0	0	0
1	0	0	0	0	1	1
1	1	0	0	0	1	1
0	1	1	1	0	1	1
0	1	1	1	0	1	1
0	0	0	0	0	0	0
0	0	0	0	0	0	0
0	0	0	0	0	1	1
0	0	0	0	0	1	1
